作者と曲名の一覧です
敬称略、アルファベット50音順です

曲名		作者名		ファイル名

		■niki
2018				2018
ARROW				ARROW
BC				BC
brilliant			brilliant
チェゲラナ			checkitoutnow
Close to you			Closetoyou
カラーコピー			color_copy
Decode				decode
ディペンデント			dependent
ELECT				ELECT
-ERROR				ERROR
FACE				FACE
指鉛筆				finger_pencil
FLARE				FLARE
GLIDE				GLIDE
グラーヴェ			grave
Hearts				Hearts
平面説				heimensetsu
HYBRID				HYBRID
ジッタードール			jitterdoll
リミッター			limiter
ロジックエージェント		logic_agent
パラノイド			Paranoid
Prototype			prototype
+REVERSE			reverse
太陽				taiyou
WAVE				WAVE
ユラギ				yuragi

		■きの
アイノウタ			ainouta
忘却模様			boukyakumoyou
バイバイ、曖昧サウンド		byebye_aimai_sound
ドラマティカ			dramatica_teto, dramatica_ritsu
FLASH BLACK			FlashBlack
From 13th			From13th
GraveKeeper			GraveKeeper
カレイド			kaleido_teto, kaleido_ritsu
まちがいさがし			machigaisagashi
SugarMelly			sugar_melly
aimai.exe			aimaiexe
コスモスライド			cosmoslide
COZMIC☆HEART			COZMIC_HEART
CrossOver			cross_over
EnToutCas			entoutcas
グロリアへ			gloria_e
Goodbye Lily			goodbye_lily
群青				gunjo
花より君に恋煩い		hanayorikimini
星降る夜と魔法のキャロル	hoshifuru
キライミライ			kiraimirai
狂い咲きアンチテーゼ		kuruizaki
La Rouge			La_Rouge
ぱんきっしゅがーる！		punkishgirl
st:Ray				stRay
サンセットゲイザー		sunset_gazer
豆乳の歌			tohnew
空想、望遠、トロイメライ	traumerei
夜明け前			yoakemae
YUME＝SHiGURE			yume_shigure
ヅブ濡レ			zubunure

		■しんたろー
Myself				Myself
バースデー			birthday
群青色の星空に			gunjoirono
春は桜、別れを染める		haruwasakura
夏色ノスタルジー		natsuzoranostalgie
ナイトシーフ			night_shief
レイニー			rainy
サクラ				sakura
主役				shuyaku
winter silence			winter_silence
夕焼けレター			yuuyake_letter

		■デスおはぎ
フレイムハート			flame_heart_teto, flame_heart_ritsu
恋ノ終ワリ			koinoowari
LOVE DISCOTHEQUE		LOVE_DISCOTHEQUE
マテリアルワールド		materialworld
Relight My Fire			RelightMyFire
しゅーてぃん☆すたー		shootingstar
World's End Celebrate		Worlds_End_Celebrate

		■ミナツキトーカ
B.R.D～叛逆の劫焔～		BRD
Baptism～贖罪のロザリィ～	Baptism
Choir - Dedicated to BRAVEs -	Choir
全てのVOC@LOIDに宣戦布告	subetenovocaloidnisensenfukoku
津々浦々			tsutsuuraura
1st color			1st_color
Creuzer				Creuzer
Lost Rose			LostRose
Sacrifice			sacrifice

		■芳田
Another Life			another_life
どこまでも無垢に広がる世界で	dokomademomukuni
Dreaming with U			Dreaming_with_U
Endless Over			endless_over
Future Sky			FutureSky
月光ラプソディ			Gekko_Rhapsody
篝火のように			kagaribinoyoni
LOST & CRY			lost_and_cry
待雪草				matsuyukisou
夏空のSELFISH			natsuzoranoselfish
over world			overworld
終末とキセキ			shumatsutokiseki
スパイラル・デイズ		SpiralDays
ヨルガオ			yorugao
夜に想う			yoruniomou

		■著作権切れ
赤とんぼ			akatonbo
アルプス一万尺			alps3030m
蝶々				chouchou
一月一日			january1st
花（四季）			hana

		■カノン
ああああ			aaaa






